 about    =  o, около
 after   =  после; после того,как
 age     =  век; возраст
 ago      =  ... тому назад
 alcohol ['%lkэhol] = спирт, алкоголь
 algorithm ['%лгэризм] = алгоритм
 all-any-some-no = все-любой-некот.й-никакой
 almost = почти
 al'ready      =  уже
 also          =  тоже, также
 always = всегда
 among                    =  среди
 and,but,or = и(а),но,или
 angry                    =  сердитый
 another-other, = другой-другие,
 answer                   =  ответ; отвечать
 any                      =  любой; какой-либо
 article                  =  статья
 as        =  как; в качестве
 as many as... = так много,как
 as well as... = так же,как
 as,since,for = так как
 ask      =  спрашивать
 atom ['%tэm]        =  атом
 a'tomic          =  атомный
 automatic [o:tэ'm%tik]   =  автоматический; автоматически
 baggage ['б%гидж] =  багаж  
 basic  =  основной
 basin [beisn] =таз, миска; водоем, бассейн
 because  =  потому что; так как
 before   =  до того как; перед тем как; раньше
 begin (began, begun) =  начинать(ся)
 beginner            =  начинающий
 between     =  между
 blank [bl%nk] = пробел, пропуск, незаполненный
 bore [bo:] = сверлить,бурить,пробираться,скука,надоедать
 both = оба,пара
 both...and... = как...так...(и...и...) 
 bring (brought, brought) =  приносить
 brother                  =  брат
 busy ['bizi] =  занятый
 but          =  но; а
 by           =  (Т. падеж  кем,чем); 
 career [kэ'riэ]    = карьера, успех, деятельность
 centre      =  центр
 century   =  век
 change                   =  менять(ся), изменять(ся)
 chapter ['ч%ptэ]         =  глава
 chemical                 =  химический
 chemist                  =  химик
 chemistry                =  химия
 choose (chose, chosen)   =  выбирать
 climate ['klaimit] = климат;атмосфера,аккл-вать(ся),приспосабливать
 clock                    =  часы
 colleague                =  коллега, сослуживец
 co'llect                 =  собирать
 co'llection              =  коллекция
 come (came, come)        =  приходить
 com'puter                 =  компьютер
 con'trol (controled) =  управлять,контролировать,управление;контроль
 copy-book                =  тетрадь
 co'rrect                =  исправлять, корректировать
 co'rrection             =  исправление, корректировка
 cosy [kэuzi] = уютный
 country                 =  страна
 couple [kApl] = пара, два, двое, несколько
 create      =  создавать, творить
 cre'ative = творческий, созидательный 
 data           =  сведения; данные
 day            =  день
 de'fect    =  дефект
 diagram             =  диаграмма; чертеж
 dictionary          =  словарь
 different           =  различный, разнообразный
 do (did, done) =  делать
 'document     =  документ
 doing-do = делающий-сделанный
 draw (drew, drawn) =  чертить, рисовать
 during       =  во время; в течение
 each         =  каждый
 eco'logical  =  экологический
 ecology                  =  экология
 economy [i(:)'konэmi]    =  экономика
 either...or... = или...или...(либо...либо)
 electric                 =  электрический
 electrician [ilek'triш(э)n] = электромонтер, электротехник
 electricity              =  электричество
 electromagnetic          =  электромагнитный
 electronic               =  электронный
 electronics              =  электроника
 element ['elimэnt]       =  элемент
 end                      =  конец 
 energy ['enэdжi]         =  энергия              
 engineer                 =  инженер
 engineering              =  техника
 ever                     =  когда либо
 every                    =  каждый
 every-each = каждый-каждый
 everything               =  все, вся
 examiner                 =  экзаменатор
 example                  =  пример
 few-little, = немногие-немногое,
 final                    =  конечный, окончательный
 find (found, found)      =  находить
 finish                   =  заканчивать, оканчивать
 first                    =  первый
 flight                   =  полет
 for                      =  для; в течение
 foreign                  =  иностранный
 friend                   =  друг
 function                 =  работать, действовать
 future                   =  будущий
 Galaxy                   =  Галактика
 garage ['g%ra:ж] = гараж, гаражный, ставить в гараж
 gas                      =  газ; газовый
 gasoline ['g%sэuli:n] =бензин, бензинный
 geographical [dжiэ'gr%fik(э)l] = географический
 geological               =  геологический
 get (got,got)            =  получать; доставать
 give (gave, given)       =  давать
 good                     =  хороший
 graduate                 =  оканчивать
 grammar                  =  грамматика
 great                    =  большой; великий
 group                    =  группа
 'hand-bag = дамская сумочка, (ручной) чемоданчик
 head                     =  возглавлять, руководить, руководитель
 hear (heard,heard)       =  слышать
 help                     =  помощь; помогать
 her                      =  ее, ей
 here                     =  здесь
 high                     =  высокий
 him                      =  ему, его
 his                      =  его
 holiday                  =  праздник
 holidays                 =  каникулы
 hour                     =  час
 how                      =  как
 hundred                  =  сотня
 idle =ленивый
 if = если
 illustrate               =  иллюстрировать
 include                  =  включать
 industrial               =  промышленный
 industry                 =  промышленность
 information              =  информация, сообщение, сведения
 instruct                 =  инструктировать, обучать
 international            =  международный
 interval                 =  перерыв
 interview ['intэvju:] = встреча,беседа,интервью,проводить опрос
 into                     =  в
 invite                   =  приглашать
 it                       =  он; она; оно;  это
 its                      =  его, ее; свой, своя, свое
 japanese                 =  японский
 job                      =  работа
 journal                  =  журнал (научный)
 just = как раз, только что
 know (knew,known)        =  знать
 knowledge                =  знание(я)
 labour =трудиться, добиваться, труд; работа
END.
